1111111111111
10010000000E1
1000011111001
1P0011C100001
1111111111111